{
  "id": "gym/bonus_room",
  "name": "Gym District — Bonus Room",
  "fixedEnemies": true,
  "exits": {
    "left": "gym/training_hall"
  },
  "enemies": [
    { "type": "swole_beast", "x": 6, "y": 4 },
    { "type": "gym_bro", "x": 10, "y": 8 }
  ],
  "chests": [
    { "x": 13, "y": 2, "loot": [{ "itemId": "double_gridlock_burger", "qty": 1 }, { "itemId": "name_brand_energy_drink", "qty": 1 }], "gold": 50 }
  ],
  "playerStart": { "x": 2, "y": 6 },
  "tiles": [
    [21, 21, 21, 21, 21, 21, 21, 21, 21, 21, 21, 21, 21, 21, 21, 21],
    [21, 20, 20, 20, 20, 20, 20, 20, 20, 20, 20, 20, 20, 20, 20, 21],
    [21, 20, 20, 20, 20, 20, 20, 20, 20, 20, 20, 20, 20, 9, 20, 21],
    [21, 20, 20, 22, 22, 20, 20, 20, 20, 20, 22, 22, 20, 20, 20, 21],
    [21, 20, 20, 22, 22, 20, 20, 20, 20, 20, 22, 22, 20, 20, 20, 21],
    [20, 20, 20, 20, 20, 20, 20, 20, 20, 20, 20, 20, 20, 20, 20, 21],
    [20, 20, 20, 20, 20, 20, 20, 20, 20, 20, 20, 20, 20, 20, 20, 21],
    [21, 20, 20, 22, 22, 20, 20, 20, 20, 20, 22, 22, 20, 20, 20, 21],
    [21, 20, 20, 22, 22, 20, 20, 20, 20, 20, 22, 22, 20, 20, 20, 21],
    [21, 20, 20, 20, 20, 20, 20, 20, 20, 20, 20, 20, 20, 20, 20, 21],
    [21, 20, 20, 20, 20, 20, 20, 20, 20, 20, 20, 20, 20, 20, 20, 21],
    [21, 21, 21, 21, 21, 21, 21, 21, 21, 21, 21, 21, 21, 21, 21, 21]
  ]
}
