{
  "id": "gym/locker_room",
  "name": "Gym District — Locker Room",
  "safe": true,
  "exits": {
    "up": "sprawl/camp",
    "right": "gym/main_floor",
    "left": "labs/entrance"
  },
  "campfires": [
    { "x": 8, "y": 5 }
  ],
  "playerStart": { "x": 8, "y": 2 },
  "tiles": [
    [21, 21, 21, 21, 21, 20, 20, 20, 20, 20, 21, 21, 21, 21, 21, 21],
    [21, 20, 20, 20, 20, 20, 20, 20, 20, 20, 20, 20, 20, 20, 20, 21],
    [21, 20, 20, 20, 20, 20, 20, 20, 20, 20, 20, 20, 20, 20, 20, 21],
    [21, 20, 22, 22, 20, 20, 20, 20, 20, 20, 20, 22, 22, 20, 20, 21],
    [21, 20, 22, 22, 20, 20, 20, 20, 20, 20, 20, 22, 22, 20, 20, 21],
    [20, 20, 20, 20, 20, 20, 20, 20, 20, 20, 20, 20, 20, 20, 20, 21],
    [20, 20, 20, 20, 20, 20, 20, 20, 20, 20, 20, 20, 20, 20, 20, 20],
    [20, 20, 20, 20, 20, 20, 20, 20, 20, 20, 20, 20, 20, 20, 20, 20],
    [21, 20, 22, 22, 20, 20, 20, 20, 20, 20, 20, 22, 22, 20, 20, 21],
    [21, 20, 22, 22, 20, 20, 20, 20, 20, 20, 20, 22, 22, 20, 20, 21],
    [21, 20, 20, 20, 20, 20, 20, 20, 20, 20, 20, 20, 20, 20, 20, 21],
    [21, 21, 21, 21, 21, 21, 21, 21, 21, 21, 21, 21, 21, 21, 21, 21]
  ]
}
