{
  "id": "gym/main_floor",
  "name": "Gym District — Main Floor",
  "fixedEnemies": true,
  "exits": {
    "left": "gym/locker_room",
    "right": "gym/weight_room",
    "down": "gym/cardio"
  },
  "enemies": [
    { "type": "protein_junkie", "x": 4, "y": 3 },
    { "type": "gym_bro", "x": 11, "y": 5 },
    { "type": "treadmill_monster", "x": 7, "y": 8 }
  ],
  "playerStart": { "x": 2, "y": 6 },
  "tiles": [
    [21, 21, 21, 21, 21, 21, 21, 21, 21, 21, 21, 21, 21, 21, 21, 21],
    [21, 20, 20, 20, 20, 20, 20, 20, 20, 20, 20, 20, 20, 20, 20, 21],
    [21, 20, 20, 20, 20, 20, 20, 20, 20, 20, 20, 20, 20, 20, 20, 21],
    [21, 20, 20, 20, 20, 20, 22, 22, 20, 20, 20, 20, 20, 20, 20, 21],
    [21, 20, 20, 20, 20, 20, 22, 22, 20, 20, 22, 20, 20, 20, 20, 21],
    [20, 20, 20, 20, 20, 20, 20, 20, 20, 20, 22, 20, 20, 20, 20, 20],
    [20, 20, 20, 20, 20, 20, 20, 20, 20, 20, 20, 20, 20, 20, 20, 20],
    [21, 20, 20, 20, 20, 20, 20, 20, 20, 20, 20, 20, 20, 20, 20, 21],
    [21, 20, 20, 22, 20, 20, 20, 20, 20, 20, 22, 20, 20, 20, 20, 21],
    [21, 20, 20, 22, 20, 20, 20, 20, 20, 20, 22, 20, 20, 20, 20, 21],
    [21, 20, 20, 20, 20, 20, 20, 20, 20, 20, 20, 20, 20, 20, 20, 21],
    [21, 21, 21, 21, 21, 20, 20, 20, 20, 20, 21, 21, 21, 21, 21, 21]
  ]
}
