{
  "id": "gym/pool",
  "name": "Gym District — Pool",
  "fixedEnemies": true,
  "exits": {
    "left": "gym/cardio",
    "down": "gym/showers"
  },
  "enemies": [
    { "type": "gym_bro", "x": 3, "y": 3 },
    { "type": "treadmill_monster", "x": 12, "y": 8 }
  ],
  "playerStart": { "x": 2, "y": 6 },
  "tiles": [
    [21, 21, 21, 21, 21, 21, 21, 21, 21, 21, 21, 21, 21, 21, 21, 21],
    [21, 20, 20, 20, 20, 20, 20, 20, 20, 20, 20, 20, 20, 20, 20, 21],
    [21, 20, 20, 20, 20, 20, 20, 20, 20, 20, 20, 20, 20, 20, 20, 21],
    [21, 20, 20, 20, 20, 3, 3, 3, 3, 3, 3, 20, 20, 20, 20, 21],
    [21, 20, 20, 20, 20, 3, 3, 3, 3, 3, 3, 20, 20, 20, 20, 21],
    [20, 20, 20, 20, 20, 3, 3, 3, 3, 3, 3, 20, 20, 20, 20, 21],
    [20, 20, 20, 20, 20, 3, 3, 3, 3, 3, 3, 20, 20, 20, 20, 21],
    [21, 20, 20, 20, 20, 3, 3, 3, 3, 3, 3, 20, 20, 20, 20, 21],
    [21, 20, 20, 20, 20, 3, 3, 3, 3, 3, 3, 20, 20, 20, 20, 21],
    [21, 20, 20, 20, 20, 20, 20, 20, 20, 20, 20, 20, 20, 20, 20, 21],
    [21, 20, 20, 20, 20, 20, 20, 20, 20, 20, 20, 20, 20, 20, 20, 21],
    [21, 21, 21, 21, 21, 20, 20, 20, 20, 20, 21, 21, 21, 21, 21, 21]
  ]
}
