{
  "id": "gym/sauna",
  "name": "Gym District — Sauna",
  "fixedEnemies": true,
  "exits": {
    "up": "gym/weight_room",
    "down": "gym/training_hall"
  },
  "enemies": [
    { "type": "protein_junkie", "x": 5, "y": 3 },
    { "type": "swole_beast", "x": 10, "y": 8 }
  ],
  "playerStart": { "x": 8, "y": 2 },
  "tiles": [
    [21, 21, 21, 21, 21, 20, 20, 20, 20, 20, 21, 21, 21, 21, 21, 21],
    [21, 20, 20, 20, 20, 20, 20, 20, 20, 20, 20, 20, 20, 20, 20, 21],
    [21, 20, 20, 20, 20, 20, 20, 20, 20, 20, 20, 20, 20, 20, 20, 21],
    [21, 20, 20, 22, 20, 20, 20, 20, 20, 20, 20, 22, 20, 20, 20, 21],
    [21, 20, 20, 22, 20, 20, 20, 20, 20, 20, 20, 22, 20, 20, 20, 21],
    [21, 20, 20, 20, 20, 20, 20, 20, 20, 20, 20, 20, 20, 20, 20, 21],
    [21, 20, 20, 20, 20, 20, 22, 22, 22, 22, 20, 20, 20, 20, 20, 21],
    [21, 20, 20, 20, 20, 20, 22, 20, 20, 22, 20, 20, 20, 20, 20, 21],
    [21, 20, 20, 20, 20, 20, 20, 20, 20, 20, 20, 20, 20, 20, 20, 21],
    [21, 20, 20, 20, 20, 20, 20, 20, 20, 20, 20, 20, 20, 20, 20, 21],
    [21, 20, 20, 20, 20, 20, 20, 20, 20, 20, 20, 20, 20, 20, 20, 21],
    [21, 21, 21, 21, 21, 20, 20, 20, 20, 20, 21, 21, 21, 21, 21, 21]
  ]
}
