{
  "id": "gym/training_hall",
  "name": "Gym District — Training Hall",
  "fixedEnemies": true,
  "exits": {
    "up": "gym/sauna",
    "right": "gym/bonus_room",
    "down": "gym/alpha_arena"
  },
  "enemies": [
    { "type": "gym_bro", "x": 12, "y": 7 }
  ],
  "npcs": [
    { "npcId": "mercedes", "x": 8, "y": 4 }
  ],
  "playerStart": { "x": 8, "y": 2 },
  "tiles": [
    [21, 21, 21, 21, 21, 20, 20, 20, 20, 20, 21, 21, 21, 21, 21, 21],
    [21, 20, 20, 20, 20, 20, 20, 20, 20, 20, 20, 20, 20, 20, 20, 21],
    [21, 20, 20, 20, 20, 20, 20, 20, 20, 20, 20, 20, 20, 20, 20, 21],
    [21, 20, 22, 20, 20, 20, 20, 20, 20, 20, 20, 20, 22, 20, 20, 21],
    [21, 20, 20, 20, 20, 20, 20, 20, 20, 20, 20, 20, 20, 20, 20, 21],
    [21, 20, 20, 20, 20, 20, 20, 20, 20, 20, 20, 20, 20, 20, 20, 20],
    [21, 20, 20, 20, 20, 20, 20, 20, 20, 20, 20, 20, 20, 20, 20, 20],
    [21, 20, 22, 20, 20, 20, 20, 20, 20, 20, 20, 20, 20, 20, 20, 21],
    [21, 20, 20, 20, 20, 20, 20, 20, 20, 20, 20, 20, 22, 20, 20, 21],
    [21, 20, 20, 20, 20, 20, 20, 20, 20, 20, 20, 20, 20, 20, 20, 21],
    [21, 20, 20, 20, 20, 20, 20, 20, 20, 20, 20, 20, 20, 20, 20, 21],
    [21, 21, 21, 21, 21, 20, 20, 20, 20, 20, 21, 21, 21, 21, 21, 21]
  ]
}
