{
  "id": "gym/weight_room",
  "name": "Gym District — Weight Room",
  "fixedEnemies": true,
  "exits": {
    "left": "gym/main_floor",
    "down": "gym/sauna"
  },
  "enemies": [
    { "type": "swole_beast", "x": 5, "y": 4 },
    { "type": "protein_junkie", "x": 11, "y": 7 }
  ],
  "chests": [
    { "x": 13, "y": 2, "loot": [{ "itemId": "lukewarm_pizza", "qty": 2 }], "gold": 25 }
  ],
  "playerStart": { "x": 2, "y": 6 },
  "tiles": [
    [21, 21, 21, 21, 21, 21, 21, 21, 21, 21, 21, 21, 21, 21, 21, 21],
    [21, 20, 20, 20, 20, 20, 20, 20, 20, 20, 20, 20, 20, 20, 20, 21],
    [21, 20, 22, 20, 20, 22, 20, 20, 20, 22, 20, 20, 20, 9, 20, 21],
    [21, 20, 22, 20, 20, 22, 20, 20, 20, 22, 20, 20, 20, 20, 20, 21],
    [21, 20, 20, 20, 20, 20, 20, 20, 20, 20, 20, 20, 20, 20, 20, 21],
    [20, 20, 20, 20, 20, 20, 20, 20, 20, 20, 20, 20, 20, 20, 20, 21],
    [20, 20, 20, 20, 20, 20, 20, 20, 20, 20, 20, 20, 20, 20, 20, 21],
    [21, 20, 22, 20, 20, 22, 20, 20, 20, 22, 20, 20, 22, 20, 20, 21],
    [21, 20, 22, 20, 20, 22, 20, 20, 20, 22, 20, 20, 22, 20, 20, 21],
    [21, 20, 20, 20, 20, 20, 20, 20, 20, 20, 20, 20, 20, 20, 20, 21],
    [21, 20, 20, 20, 20, 20, 20, 20, 20, 20, 20, 20, 20, 20, 20, 21],
    [21, 21, 21, 21, 21, 20, 20, 20, 20, 20, 21, 21, 21, 21, 21, 21]
  ]
}
