{
  "id": "underworld/depths",
  "name": "The Depths",
  "safe": false,
  "exits": {
    "up": "underworld/halls"
  },
  "playerStart": { "x": 8, "y": 1 },
  "enemies": [
    { "type": "ghost_intern", "x": 3, "y": 3 },
    { "type": "ghost_intern", "x": 12, "y": 3 },
    { "type": "ghost_intern", "x": 5, "y": 8 },
    { "type": "ghost_intern", "x": 10, "y": 8 },
    { "type": "ghost_intern", "x": 8, "y": 6 }
  ],
  "chests": [
    { "x": 8, "y": 10, "loot": [{ "itemId": "gas_station_burrito", "qty": 3 }], "gold": 25 }
  ],
  "npcs": [],
  "campfires": [],
  "tiles": [
    [0, 0, 0, 10, 10, 10, 6, 6, 6, 6, 10, 10, 10, 0, 0, 0],
    [0, 0, 10, 10, 6, 6, 6, 6, 6, 6, 6, 6, 10, 10, 0, 0],
    [0, 0, 10, 6, 6, 6, 6, 6, 6, 6, 6, 6, 6, 10, 0, 0],
    [0, 0, 10, 6, 6, 6, 6, 10, 10, 6, 6, 6, 6, 10, 0, 0],
    [0, 0, 10, 6, 6, 6, 6, 10, 10, 6, 6, 6, 6, 10, 0, 0],
    [0, 0, 10, 6, 6, 6, 6, 6, 6, 6, 6, 6, 6, 10, 0, 0],
    [0, 0, 10, 6, 6, 6, 6, 6, 6, 6, 6, 6, 6, 10, 0, 0],
    [0, 0, 10, 6, 6, 6, 6, 6, 6, 6, 6, 6, 6, 10, 0, 0],
    [0, 0, 10, 6, 6, 6, 6, 6, 6, 6, 6, 6, 6, 10, 0, 0],
    [0, 0, 10, 6, 6, 6, 6, 6, 6, 6, 6, 6, 6, 10, 0, 0],
    [0, 0, 10, 6, 6, 6, 6, 6, 6, 6, 6, 6, 6, 10, 0, 0],
    [0, 0, 10, 10, 10, 10, 10, 10, 10, 10, 10, 10, 10, 10, 0, 0]
  ]
}
