{
  "id": "underworld/gate",
  "name": "The Underworld Gate",
  "safe": false,
  "exits": {
    "down": "underworld/halls"
  },
  "playerStart": { "x": 8, "y": 2 },
  "enemies": [],
  "chests": [],
  "npcs": [
    { "npcId": "marvin", "x": 8, "y": 5 }
  ],
  "campfires": [],
  "tiles": [
    [0, 0, 0, 0, 0, 0, 0, 0, 0, 0, 0, 0, 0, 0, 0, 0],
    [0, 0, 10, 10, 10, 10, 10, 10, 10, 10, 10, 10, 10, 10, 0, 0],
    [0, 0, 10, 6, 6, 6, 6, 6, 6, 6, 6, 6, 6, 10, 0, 0],
    [0, 0, 10, 6, 6, 6, 6, 6, 6, 6, 6, 6, 6, 10, 0, 0],
    [0, 0, 10, 6, 6, 6, 6, 6, 6, 6, 6, 6, 6, 10, 0, 0],
    [0, 0, 10, 6, 6, 6, 6, 6, 6, 6, 6, 6, 6, 10, 0, 0],
    [0, 0, 10, 6, 6, 6, 6, 6, 6, 6, 6, 6, 6, 10, 0, 0],
    [0, 0, 10, 6, 6, 6, 10, 10, 10, 10, 6, 6, 6, 10, 0, 0],
    [0, 0, 10, 6, 6, 6, 10, 0, 0, 10, 6, 6, 6, 10, 0, 0],
    [0, 0, 10, 6, 6, 6, 6, 6, 6, 6, 6, 6, 6, 10, 0, 0],
    [0, 0, 10, 6, 6, 6, 6, 6, 6, 6, 6, 6, 6, 10, 0, 0],
    [0, 0, 10, 10, 10, 10, 6, 6, 6, 6, 10, 10, 10, 10, 0, 0]
  ]
}
