{
  "id": "underworld/halls",
  "name": "Intern Halls",
  "safe": false,
  "exits": {
    "up": "underworld/gate",
    "down": "underworld/depths"
  },
  "playerStart": { "x": 8, "y": 1 },
  "enemies": [
    { "type": "ghost_intern", "x": 4, "y": 4 },
    { "type": "ghost_intern", "x": 11, "y": 6 },
    { "type": "ghost_intern", "x": 6, "y": 9 }
  ],
  "chests": [],
  "npcs": [
    { "npcId": "underworld_merchant", "x": 10, "y": 4 }
  ],
  "campfires": [],
  "tiles": [
    [0, 0, 10, 10, 10, 10, 6, 6, 6, 6, 10, 10, 10, 10, 0, 0],
    [0, 0, 10, 6, 6, 6, 6, 6, 6, 6, 6, 6, 6, 10, 0, 0],
    [0, 0, 10, 6, 6, 6, 6, 6, 6, 6, 6, 6, 6, 10, 0, 0],
    [0, 0, 10, 6, 6, 6, 6, 10, 10, 6, 6, 6, 6, 10, 0, 0],
    [0, 0, 10, 6, 6, 6, 6, 10, 10, 6, 6, 6, 6, 10, 0, 0],
    [0, 0, 10, 6, 6, 6, 6, 6, 6, 6, 6, 6, 6, 10, 0, 0],
    [0, 0, 10, 6, 6, 6, 6, 6, 6, 6, 6, 6, 6, 10, 0, 0],
    [0, 0, 10, 10, 10, 6, 6, 6, 6, 6, 6, 10, 10, 10, 0, 0],
    [0, 0, 0, 10, 10, 6, 6, 6, 6, 6, 6, 10, 10, 0, 0, 0],
    [0, 0, 0, 10, 6, 6, 6, 6, 6, 6, 6, 6, 10, 0, 0, 0],
    [0, 0, 0, 10, 6, 6, 6, 6, 6, 6, 6, 6, 10, 0, 0, 0],
    [0, 0, 0, 10, 10, 10, 6, 6, 6, 6, 10, 10, 10, 0, 0, 0]
  ]
}
