{
  "id": "island/descent",
  "name": "Consultant's Island — Descent",
  "fixedEnemies": true,
  "exits": {
    "up": "island/office",
    "down": "island/ritual_chamber"
  },
  "enemies": [
    { "type": "cult_acolyte", "x": 5, "y": 4 },
    { "type": "cult_acolyte", "x": 11, "y": 8 }
  ],
  "playerStart": { "x": 8, "y": 2 },
  "tiles": [
    [29, 29, 29, 29, 29, 28, 28, 28, 28, 28, 29, 29, 29, 29, 29, 29],
    [29, 28, 28, 28, 28, 28, 28, 28, 28, 28, 28, 28, 28, 28, 28, 29],
    [29, 28, 28, 28, 28, 28, 28, 28, 28, 28, 28, 28, 28, 28, 28, 29],
    [29, 28, 28, 28, 28, 28, 28, 28, 28, 28, 28, 28, 28, 28, 28, 29],
    [29, 28, 28, 28, 28, 28, 28, 28, 28, 28, 28, 28, 28, 28, 28, 29],
    [29, 28, 28, 28, 28, 28, 28, 28, 28, 28, 28, 28, 28, 28, 28, 29],
    [29, 28, 28, 28, 28, 28, 28, 28, 28, 28, 28, 28, 28, 28, 28, 29],
    [29, 28, 28, 28, 28, 28, 28, 28, 28, 28, 28, 28, 28, 28, 28, 29],
    [29, 28, 28, 28, 28, 28, 28, 28, 28, 28, 28, 28, 28, 28, 28, 29],
    [29, 28, 28, 28, 28, 28, 28, 28, 28, 28, 28, 28, 28, 28, 28, 29],
    [29, 28, 28, 28, 28, 28, 28, 28, 28, 28, 28, 28, 28, 28, 28, 29],
    [29, 29, 29, 29, 29, 28, 28, 28, 28, 28, 29, 29, 29, 29, 29, 29]
  ]
}
