{
  "id": "island/lobby",
  "name": "Consultant's Island — Lobby",
  "fixedEnemies": true,
  "exits": {
    "left": "island/dock",
    "right": "island/lounge",
    "down": "island/executive_hall"
  },
  "enemies": [
    { "type": "elite_guard", "x": 8, "y": 3 },
    { "type": "security_drone", "x": 4, "y": 7 },
    { "type": "cult_acolyte", "x": 12, "y": 8 }
  ],
  "playerStart": { "x": 2, "y": 6 },
  "tiles": [
    [27, 27, 27, 27, 27, 27, 27, 27, 27, 27, 27, 27, 27, 27, 27, 27],
    [27, 26, 26, 26, 26, 26, 26, 26, 26, 26, 26, 26, 26, 26, 26, 27],
    [27, 26, 26, 26, 26, 26, 26, 26, 26, 26, 26, 26, 26, 26, 26, 27],
    [27, 26, 26, 26, 26, 26, 26, 26, 26, 26, 26, 26, 26, 26, 26, 27],
    [27, 26, 26, 26, 26, 26, 26, 26, 26, 26, 26, 26, 26, 26, 26, 27],
    [26, 26, 26, 26, 26, 26, 26, 26, 26, 26, 26, 26, 26, 26, 26, 26],
    [26, 26, 26, 26, 26, 26, 26, 26, 26, 26, 26, 26, 26, 26, 26, 26],
    [27, 26, 26, 26, 26, 26, 26, 26, 26, 26, 26, 26, 26, 26, 26, 27],
    [27, 26, 26, 26, 26, 26, 26, 26, 26, 26, 26, 26, 26, 26, 26, 27],
    [27, 26, 26, 26, 26, 26, 26, 26, 26, 26, 26, 26, 26, 26, 26, 27],
    [27, 26, 26, 26, 26, 26, 26, 26, 26, 26, 26, 26, 26, 26, 26, 27],
    [27, 27, 27, 27, 27, 26, 26, 26, 26, 26, 27, 27, 27, 27, 27, 27]
  ]
}
