{
  "id": "island/mech_bay",
  "name": "Consultant's Island — Mech Bay",
  "fixedEnemies": true,
  "exits": {
    "left": "island/ritual_chamber",
    "down": "island/inner_sanctum"
  },
  "enemies": [
    { "type": "security_drone", "x": 5, "y": 4 },
    { "type": "elite_guard", "x": 11, "y": 7 }
  ],
  "playerStart": { "x": 2, "y": 6 },
  "tiles": [
    [29, 29, 29, 29, 29, 29, 29, 29, 29, 29, 29, 29, 29, 29, 29, 29],
    [29, 28, 28, 28, 28, 28, 28, 28, 28, 28, 28, 28, 28, 28, 28, 29],
    [29, 28, 28, 28, 28, 28, 28, 28, 28, 28, 28, 28, 28, 28, 28, 29],
    [29, 28, 28, 29, 28, 28, 28, 28, 28, 28, 28, 29, 28, 28, 28, 29],
    [29, 28, 28, 29, 28, 28, 28, 28, 28, 28, 28, 29, 28, 28, 28, 29],
    [28, 28, 28, 28, 28, 28, 28, 28, 28, 28, 28, 28, 28, 28, 28, 29],
    [28, 28, 28, 28, 28, 28, 28, 28, 28, 28, 28, 28, 28, 28, 28, 29],
    [29, 28, 28, 29, 28, 28, 28, 28, 28, 28, 28, 29, 28, 28, 28, 29],
    [29, 28, 28, 29, 28, 28, 28, 28, 28, 28, 28, 29, 28, 28, 28, 29],
    [29, 28, 28, 28, 28, 28, 28, 28, 28, 28, 28, 28, 28, 28, 28, 29],
    [29, 28, 28, 28, 28, 28, 28, 28, 28, 28, 28, 28, 28, 28, 28, 29],
    [29, 29, 29, 29, 29, 28, 28, 28, 28, 28, 29, 29, 29, 29, 29, 29]
  ]
}
