{
  "id": "island/office",
  "name": "Consultant's Island — Office",
  "fixedEnemies": true,
  "exits": {
    "up": "island/penthouse_approach",
    "down": "island/descent"
  },
  "enemies": [
    { "type": "the_consultant", "x": 8, "y": 4 }
  ],
  "playerStart": { "x": 8, "y": 9 },
  "tiles": [
    [27, 27, 27, 27, 27, 26, 26, 26, 26, 26, 27, 27, 27, 27, 27, 27],
    [27, 26, 26, 26, 26, 26, 26, 26, 26, 26, 26, 26, 26, 26, 26, 27],
    [27, 26, 26, 26, 26, 26, 26, 26, 26, 26, 26, 26, 26, 26, 26, 27],
    [27, 26, 26, 27, 27, 26, 26, 26, 26, 26, 27, 27, 26, 26, 26, 27],
    [27, 26, 26, 27, 27, 26, 26, 26, 26, 26, 27, 27, 26, 26, 26, 27],
    [27, 26, 26, 26, 26, 26, 26, 26, 26, 26, 26, 26, 26, 26, 26, 27],
    [27, 26, 26, 26, 26, 26, 26, 26, 26, 26, 26, 26, 26, 26, 26, 27],
    [27, 26, 26, 27, 27, 26, 26, 26, 26, 26, 27, 27, 26, 26, 26, 27],
    [27, 26, 26, 27, 27, 26, 26, 26, 26, 26, 27, 27, 26, 26, 26, 27],
    [27, 26, 26, 26, 26, 26, 26, 26, 26, 26, 26, 26, 26, 26, 26, 27],
    [27, 26, 26, 26, 26, 26, 26, 26, 26, 26, 26, 26, 26, 26, 26, 27],
    [27, 27, 27, 27, 27, 26, 26, 26, 26, 26, 27, 27, 27, 27, 27, 27]
  ]
}
