{
  "id": "island/treasure",
  "name": "Consultant's Island — Treasure Room",
  "fixedEnemies": true,
  "exits": {
    "up": "island/archives"
  },
  "enemies": [
    { "type": "void_wraith", "x": 8, "y": 8 }
  ],
  "chests": [
    { "x": 4, "y": 4, "loot": [{ "itemId": "artisanal_kale_wrap", "qty": 3 }], "gold": 100 },
    { "x": 11, "y": 4, "loot": [{ "itemId": "dubious_nootropic", "qty": 2 }], "gold": 120 }
  ],
  "playerStart": { "x": 8, "y": 2 },
  "tiles": [
    [29, 29, 29, 29, 29, 28, 28, 28, 28, 28, 29, 29, 29, 29, 29, 29],
    [29, 28, 28, 28, 28, 28, 28, 28, 28, 28, 28, 28, 28, 28, 28, 29],
    [29, 28, 28, 28, 28, 28, 28, 28, 28, 28, 28, 28, 28, 28, 28, 29],
    [29, 28, 28, 28, 28, 28, 28, 28, 28, 28, 28, 28, 28, 28, 28, 29],
    [29, 28, 28, 28, 9, 28, 28, 28, 28, 28, 28, 9, 28, 28, 28, 29],
    [29, 28, 28, 28, 28, 28, 28, 28, 28, 28, 28, 28, 28, 28, 28, 29],
    [29, 28, 28, 28, 28, 28, 28, 28, 28, 28, 28, 28, 28, 28, 28, 29],
    [29, 28, 28, 28, 28, 28, 28, 28, 28, 28, 28, 28, 28, 28, 28, 29],
    [29, 28, 28, 28, 28, 28, 28, 28, 28, 28, 28, 28, 28, 28, 28, 29],
    [29, 28, 28, 28, 28, 28, 28, 28, 28, 28, 28, 28, 28, 28, 28, 29],
    [29, 28, 28, 28, 28, 28, 28, 28, 28, 28, 28, 28, 28, 28, 28, 29],
    [29, 29, 29, 29, 29, 29, 29, 29, 29, 29, 29, 29, 29, 29, 29, 29]
  ]
}
