{
  "id": "sewer/deep",
  "name": "Deep Sewers",
  "fixedEnemies": true,
  "exits": {
    "up": "sewer/waterway",
    "left": "sewer/throne"
  },
  "enemies": [
    { "type": "toxic_slime", "x": 5, "y": 4 },
    { "type": "toxic_slime", "x": 11, "y": 7 }
  ],
  "chests": [
    { "x": 13, "y": 3, "loot": [{ "itemId": "taser", "qty": 1 }, { "itemId": "scanner", "qty": 1 }], "gold": 25 }
  ],
  "playerStart": { "x": 8, "y": 2 },
  "tiles": [
    [11, 11, 11, 11, 11, 11, 11, 12, 12, 11, 11, 11, 11, 11, 11, 11],
    [11, 12, 12, 12, 12, 12, 12, 12, 12, 12, 12, 12, 12, 12, 12, 11],
    [12, 12, 12, 12, 12, 12, 12, 12, 12, 12, 12, 12, 12, 12, 12, 11],
    [11, 12, 12, 12, 13, 13, 12, 12, 12, 12, 13, 13, 12, 12, 12, 11],
    [11, 12, 12, 12, 13, 13, 12, 12, 12, 12, 13, 13, 12, 12, 12, 11],
    [12, 12, 12, 12, 12, 12, 12, 12, 12, 12, 12, 12, 12, 12, 12, 11],
    [12, 12, 12, 12, 12, 12, 12, 12, 12, 12, 12, 12, 12, 12, 12, 11],
    [11, 12, 12, 12, 12, 12, 12, 13, 13, 12, 12, 12, 12, 12, 12, 11],
    [11, 12, 12, 12, 12, 12, 12, 13, 13, 12, 12, 12, 12, 12, 12, 11],
    [11, 12, 12, 12, 12, 12, 12, 12, 12, 12, 12, 12, 12, 12, 12, 11],
    [11, 12, 12, 12, 12, 12, 12, 12, 12, 12, 12, 12, 12, 12, 12, 11],
    [11, 11, 11, 11, 11, 11, 11, 11, 11, 11, 11, 11, 11, 11, 11, 11]
  ]
}
