{
  "id": "sewer/entrance",
  "name": "Sewer Entrance",
  "fixedEnemies": true,
  "exits": {
    "up": "grymhold/town_2",
    "down": "sewer/tunnel_1"
  },
  "enemies": [
    { "type": "sewer_rat", "x": 5, "y": 4 },
    { "type": "sewer_rat", "x": 10, "y": 7 }
  ],
  "campfires": [
    { "x": 3, "y": 3 }
  ],
  "playerStart": { "x": 8, "y": 2 },
  "tiles": [
    [11, 11, 11, 11, 11, 11, 11, 12, 12, 11, 11, 11, 11, 11, 11, 11],
    [11, 12, 12, 12, 12, 12, 12, 12, 12, 12, 12, 12, 12, 12, 12, 11],
    [12, 12, 12, 12, 12, 12, 12, 12, 12, 12, 12, 12, 12, 12, 12, 11],
    [11, 12, 12, 12, 12, 12, 12, 12, 12, 12, 12, 12, 12, 12, 12, 11],
    [11, 12, 12, 12, 12, 12, 12, 12, 12, 12, 12, 13, 13, 12, 12, 11],
    [11, 12, 12, 12, 12, 12, 12, 12, 12, 12, 12, 13, 13, 12, 12, 11],
    [11, 12, 12, 13, 13, 12, 12, 12, 12, 12, 12, 12, 12, 12, 12, 11],
    [11, 12, 12, 13, 13, 12, 12, 12, 12, 12, 12, 12, 12, 12, 12, 11],
    [11, 12, 12, 12, 12, 12, 12, 12, 12, 12, 12, 12, 12, 12, 12, 11],
    [11, 12, 12, 12, 12, 12, 12, 12, 12, 12, 12, 12, 12, 12, 12, 11],
    [11, 11, 11, 11, 11, 12, 12, 12, 12, 12, 12, 11, 11, 11, 11, 11],
    [11, 11, 11, 11, 11, 12, 12, 12, 12, 12, 12, 11, 11, 11, 11, 11]
  ]
}
