{
  "id": "sewer/rats_nest",
  "name": "Rat's Nest",
  "fixedEnemies": true,
  "exits": {
    "up": "sewer/tunnel_2",
    "right": "sewer/throne"
  },
  "enemies": [
    { "type": "sewer_rat", "x": 4, "y": 3 },
    { "type": "sewer_rat", "x": 7, "y": 5 },
    { "type": "sewer_rat", "x": 10, "y": 4 },
    { "type": "sewer_rat", "x": 12, "y": 8 }
  ],
  "playerStart": { "x": 8, "y": 2 },
  "tiles": [
    [11, 11, 11, 11, 11, 11, 11, 11, 11, 11, 11, 11, 11, 11, 11, 11],
    [11, 12, 12, 12, 12, 12, 12, 12, 12, 12, 12, 12, 12, 12, 12, 11],
    [12, 12, 12, 12, 12, 12, 12, 12, 12, 12, 12, 12, 12, 12, 12, 11],
    [11, 12, 12, 12, 12, 12, 12, 12, 12, 12, 12, 12, 12, 12, 12, 11],
    [11, 12, 12, 12, 12, 12, 12, 12, 12, 12, 12, 12, 12, 12, 12, 11],
    [11, 12, 12, 12, 12, 12, 12, 12, 12, 12, 12, 12, 12, 12, 12, 12],
    [11, 12, 12, 12, 12, 12, 12, 12, 12, 12, 12, 12, 12, 12, 12, 12],
    [11, 12, 12, 13, 13, 12, 12, 12, 12, 13, 13, 12, 12, 12, 12, 11],
    [11, 12, 12, 13, 13, 12, 12, 12, 12, 13, 13, 12, 12, 12, 12, 11],
    [11, 12, 12, 12, 12, 12, 12, 12, 12, 12, 12, 12, 12, 12, 12, 11],
    [11, 12, 12, 12, 12, 12, 12, 12, 12, 12, 12, 12, 12, 12, 12, 11],
    [11, 11, 11, 11, 11, 11, 11, 11, 11, 11, 11, 11, 11, 11, 11, 11]
  ]
}
