{
  "id": "sewer/throne",
  "name": "Sewer King's Throne",
  "fixedEnemies": true,
  "exits": {
    "left": "sewer/rats_nest",
    "right": "sewer/deep"
  },
  "enemies": [
    { "type": "sewer_king", "x": 8, "y": 5 }
  ],
  "playerStart": { "x": 3, "y": 6 },
  "tiles": [
    [11, 11, 11, 11, 11, 11, 11, 11, 11, 11, 11, 11, 11, 11, 11, 11],
    [11, 12, 12, 12, 12, 12, 12, 12, 12, 12, 12, 12, 12, 12, 12, 11],
    [11, 12, 12, 12, 12, 12, 12, 12, 12, 12, 12, 12, 12, 12, 12, 11],
    [11, 12, 12, 13, 13, 12, 12, 12, 12, 12, 12, 13, 13, 12, 12, 11],
    [11, 12, 12, 13, 13, 12, 12, 12, 12, 12, 12, 13, 13, 12, 12, 11],
    [11, 12, 12, 12, 12, 12, 12, 12, 12, 12, 12, 12, 12, 12, 12, 11],
    [12, 12, 12, 12, 12, 12, 12, 12, 12, 12, 12, 12, 12, 12, 12, 12],
    [12, 12, 12, 12, 12, 12, 12, 12, 12, 12, 12, 12, 12, 12, 12, 12],
    [11, 12, 12, 13, 13, 12, 12, 12, 12, 12, 12, 13, 13, 12, 12, 11],
    [11, 12, 12, 13, 13, 12, 12, 12, 12, 12, 12, 13, 13, 12, 12, 11],
    [11, 12, 12, 12, 12, 12, 12, 12, 12, 12, 12, 12, 12, 12, 12, 11],
    [11, 11, 11, 11, 11, 11, 11, 11, 11, 11, 11, 11, 11, 11, 11, 11]
  ]
}
