{
  "id": "sewer/tunnel_1",
  "name": "Sewer Tunnel",
  "fixedEnemies": true,
  "exits": {
    "up": "sewer/entrance",
    "right": "sewer/junction",
    "down": "sewer/tunnel_2"
  },
  "enemies": [
    { "type": "sewer_rat", "x": 4, "y": 5 },
    { "type": "sewer_rat", "x": 8, "y": 3 },
    { "type": "sewer_rat", "x": 12, "y": 7 }
  ],
  "chests": [
    { "x": 13, "y": 3, "loot": [{ "itemId": "gas_station_burrito", "qty": 3 }, { "itemId": "cheap_energy_drink", "qty": 1 }], "gold": 15 }
  ],
  "playerStart": { "x": 8, "y": 2 },
  "tiles": [
    [11, 11, 11, 11, 11, 11, 11, 12, 12, 11, 11, 11, 11, 11, 11, 11],
    [11, 12, 12, 12, 12, 12, 12, 12, 12, 12, 12, 12, 12, 12, 12, 11],
    [12, 12, 12, 12, 12, 12, 12, 12, 12, 12, 12, 12, 12, 12, 12, 11],
    [11, 12, 12, 12, 12, 12, 12, 12, 12, 12, 12, 12, 12, 12, 12, 12],
    [11, 13, 13, 12, 12, 12, 12, 12, 12, 12, 13, 13, 12, 12, 12, 12],
    [11, 13, 13, 12, 12, 12, 12, 12, 12, 12, 13, 13, 12, 12, 12, 11],
    [11, 12, 12, 12, 12, 12, 12, 12, 12, 12, 12, 12, 12, 12, 12, 11],
    [11, 12, 12, 12, 12, 12, 12, 12, 12, 12, 12, 12, 12, 12, 12, 11],
    [11, 12, 12, 12, 12, 12, 12, 12, 12, 12, 12, 12, 12, 12, 12, 11],
    [11, 12, 12, 12, 12, 12, 12, 12, 12, 12, 12, 12, 12, 12, 12, 11],
    [11, 11, 11, 11, 11, 12, 12, 12, 12, 12, 12, 11, 11, 11, 11, 11],
    [11, 11, 11, 11, 11, 12, 12, 12, 12, 12, 12, 11, 11, 11, 11, 11]
  ]
}
