{
  "id": "sewer/waterway",
  "name": "Sewer Waterway",
  "fixedEnemies": true,
  "exits": {
    "up": "sewer/junction",
    "down": "sewer/deep"
  },
  "enemies": [
    { "type": "toxic_slime", "x": 4, "y": 4 },
    { "type": "toxic_slime", "x": 11, "y": 7 }
  ],
  "chests": [
    { "x": 13, "y": 5, "loot": [{ "itemId": "chain_mail", "qty": 1 }], "gold": 20 }
  ],
  "playerStart": { "x": 8, "y": 2 },
  "tiles": [
    [11, 11, 11, 11, 11, 11, 11, 11, 11, 11, 11, 11, 11, 11, 11, 11],
    [11, 12, 12, 12, 12, 12, 12, 12, 12, 12, 12, 12, 12, 12, 12, 11],
    [12, 12, 12, 12, 12, 12, 12, 12, 12, 12, 12, 12, 12, 12, 12, 11],
    [11, 12, 12, 12, 12, 13, 13, 13, 13, 13, 12, 12, 12, 12, 12, 11],
    [11, 12, 12, 12, 12, 13, 13, 13, 13, 13, 12, 12, 12, 12, 12, 11],
    [11, 12, 12, 12, 12, 13, 13, 13, 13, 13, 12, 12, 12, 12, 12, 11],
    [11, 12, 12, 12, 12, 13, 13, 13, 13, 13, 12, 12, 12, 12, 12, 11],
    [11, 12, 12, 12, 12, 12, 12, 12, 12, 12, 12, 12, 12, 12, 12, 11],
    [11, 12, 12, 12, 12, 12, 12, 12, 12, 12, 12, 12, 12, 12, 12, 11],
    [11, 12, 12, 12, 12, 12, 12, 12, 12, 12, 12, 12, 12, 12, 12, 11],
    [11, 11, 11, 11, 11, 12, 12, 12, 12, 12, 12, 11, 11, 11, 11, 11],
    [11, 11, 11, 11, 11, 12, 12, 12, 12, 12, 12, 11, 11, 11, 11, 11]
  ]
}
