{
  "id": "cave_1/room_1",
  "name": "Cave Entrance",
  "exits": {
    "left": "grymhold/town_2",
    "down": "cave_1/room_2"
  },
  "playerStart": { "x": 8, "y": 6 },
  "enemies": [
    { "type": "bat", "x": 5, "y": 4 },
    { "type": "bat", "x": 10, "y": 7 }
  ],
  "chests": [
    { "x": 12, "y": 3, "loot": [{ "itemId": "gas_station_burrito", "qty": 2 }], "gold": 10 }
  ],
  "tiles": [
    [7, 7, 7, 7, 7, 7, 7, 7, 7, 7, 7, 7, 7, 7, 7, 7],
    [5, 5, 8, 8, 7, 7, 8, 8, 8, 8, 7, 7, 8, 8, 8, 7],
    [5, 5, 8, 8, 7, 7, 8, 8, 8, 8, 7, 7, 8, 8, 8, 7],
    [7, 7, 8, 8, 7, 7, 8, 8, 8, 8, 8, 8, 8, 8, 8, 7],
    [7, 7, 8, 8, 8, 8, 8, 8, 8, 8, 8, 8, 8, 7, 7, 7],
    [7, 7, 8, 8, 8, 8, 8, 8, 8, 8, 8, 8, 8, 7, 7, 7],
    [7, 7, 8, 8, 8, 8, 8, 8, 8, 8, 8, 8, 8, 7, 7, 7],
    [7, 7, 8, 8, 8, 8, 8, 7, 7, 8, 8, 8, 8, 7, 7, 7],
    [7, 7, 8, 8, 8, 8, 8, 7, 7, 8, 8, 8, 8, 7, 7, 7],
    [7, 7, 7, 7, 8, 8, 8, 8, 8, 8, 8, 7, 7, 7, 7, 7],
    [7, 7, 7, 7, 8, 8, 8, 8, 8, 8, 8, 7, 7, 7, 7, 7],
    [7, 7, 7, 7, 8, 8, 8, 8, 8, 8, 8, 7, 7, 7, 7, 7]
  ]
}
