{
  "id": "retail/clothing",
  "name": "Retail Ruins — Clothing Dept",
  "fixedEnemies": true,
  "exits": {
    "left": "retail/entrance",
    "right": "retail/electronics"
  },
  "enemies": [
    { "type": "corrupted_cashier", "x": 5, "y": 4 },
    { "type": "retail_bot", "x": 11, "y": 7 }
  ],
  "playerStart": { "x": 2, "y": 6 },
  "tiles": [
    [18, 18, 18, 18, 18, 18, 18, 18, 18, 18, 18, 18, 18, 18, 18, 18],
    [18, 17, 17, 19, 17, 17, 19, 17, 17, 19, 17, 17, 19, 17, 17, 18],
    [18, 17, 17, 19, 17, 17, 19, 17, 17, 19, 17, 17, 19, 17, 17, 18],
    [18, 17, 17, 17, 17, 17, 17, 17, 17, 17, 17, 17, 17, 17, 17, 18],
    [18, 17, 17, 17, 17, 17, 17, 17, 17, 17, 17, 17, 17, 17, 17, 18],
    [17, 17, 17, 17, 17, 17, 17, 17, 17, 17, 17, 17, 17, 17, 17, 17],
    [17, 17, 17, 17, 17, 17, 17, 17, 17, 17, 17, 17, 17, 17, 17, 17],
    [18, 17, 17, 17, 17, 17, 17, 17, 17, 17, 17, 17, 17, 17, 17, 18],
    [18, 17, 17, 19, 17, 17, 19, 17, 17, 19, 17, 17, 19, 17, 17, 18],
    [18, 17, 17, 19, 17, 17, 19, 17, 17, 19, 17, 17, 19, 17, 17, 18],
    [18, 17, 17, 17, 17, 17, 17, 17, 17, 17, 17, 17, 17, 17, 17, 18],
    [18, 18, 18, 18, 18, 18, 18, 18, 18, 18, 18, 18, 18, 18, 18, 18]
  ]
}
