{
  "id": "retail/electronics",
  "name": "Retail Ruins — Electronics",
  "fixedEnemies": true,
  "exits": {
    "left": "retail/clothing",
    "down": "retail/security"
  },
  "enemies": [
    { "type": "price_scanner", "x": 5, "y": 3 },
    { "type": "retail_bot", "x": 10, "y": 8 },
    { "type": "shopping_cart_golem", "x": 13, "y": 5 }
  ],
  "chests": [
    { "x": 2, "y": 2, "loot": [{ "itemId": "cheap_energy_drink", "qty": 2 }], "gold": 30 }
  ],
  "playerStart": { "x": 2, "y": 6 },
  "tiles": [
    [18, 18, 18, 18, 18, 18, 18, 18, 18, 18, 18, 18, 18, 18, 18, 18],
    [18, 17, 17, 17, 17, 19, 17, 17, 17, 17, 19, 17, 17, 17, 17, 18],
    [18, 17, 9, 17, 17, 19, 17, 17, 17, 17, 19, 17, 17, 17, 17, 18],
    [18, 17, 17, 17, 17, 17, 17, 17, 17, 17, 17, 17, 17, 17, 17, 18],
    [18, 17, 17, 17, 17, 17, 17, 17, 17, 17, 17, 17, 17, 17, 17, 18],
    [17, 17, 17, 17, 17, 17, 17, 17, 17, 17, 17, 17, 17, 17, 17, 18],
    [17, 17, 17, 17, 17, 17, 17, 17, 17, 17, 17, 17, 17, 17, 17, 18],
    [18, 17, 17, 17, 17, 17, 17, 17, 17, 17, 17, 17, 17, 17, 17, 18],
    [18, 17, 17, 17, 17, 19, 17, 17, 17, 17, 19, 17, 17, 17, 17, 18],
    [18, 17, 17, 17, 17, 19, 17, 17, 17, 17, 19, 17, 17, 17, 17, 18],
    [18, 17, 17, 17, 17, 17, 17, 17, 17, 17, 17, 17, 17, 17, 17, 18],
    [18, 18, 18, 18, 18, 17, 17, 17, 17, 17, 18, 18, 18, 18, 18, 18]
  ]
}
