{
  "id": "retail/entrance",
  "name": "Retail Ruins — Entrance",
  "fixedEnemies": true,
  "exits": {
    "left": "sprawl/bridge",
    "right": "retail/clothing",
    "down": "retail/food_court"
  },
  "enemies": [
    { "type": "retail_bot", "x": 6, "y": 4 },
    { "type": "price_scanner", "x": 11, "y": 7 }
  ],
  "campfires": [
    { "x": 3, "y": 3 }
  ],
  "playerStart": { "x": 2, "y": 6 },
  "tiles": [
    [18, 18, 18, 18, 18, 18, 18, 18, 18, 18, 18, 18, 18, 18, 18, 18],
    [18, 17, 17, 17, 17, 17, 17, 17, 17, 17, 17, 17, 17, 17, 17, 18],
    [18, 17, 17, 17, 17, 17, 17, 17, 17, 17, 17, 17, 17, 17, 17, 18],
    [18, 17, 17, 17, 17, 17, 17, 17, 17, 17, 17, 17, 17, 17, 17, 18],
    [18, 17, 17, 17, 17, 17, 17, 17, 17, 17, 17, 17, 17, 17, 17, 18],
    [17, 17, 17, 17, 17, 17, 17, 17, 17, 17, 17, 17, 17, 17, 17, 17],
    [17, 17, 17, 17, 17, 17, 17, 17, 17, 17, 17, 17, 17, 17, 17, 17],
    [18, 17, 17, 17, 17, 17, 17, 17, 17, 17, 17, 17, 17, 17, 17, 18],
    [18, 17, 17, 17, 17, 17, 17, 17, 17, 17, 17, 17, 17, 17, 17, 18],
    [18, 17, 17, 17, 17, 17, 17, 17, 17, 17, 17, 17, 17, 17, 17, 18],
    [18, 17, 17, 17, 17, 17, 17, 17, 17, 17, 17, 17, 17, 17, 17, 18],
    [18, 18, 18, 18, 18, 17, 17, 17, 17, 17, 18, 18, 18, 18, 18, 18]
  ]
}
