{
  "id": "retail/escalator",
  "name": "Retail Ruins — Broken Escalator",
  "fixedEnemies": true,
  "exits": {
    "up": "retail/back_room",
    "down": "retail/storage"
  },
  "enemies": [
    { "type": "shopping_cart_golem", "x": 7, "y": 5 },
    { "type": "price_scanner", "x": 12, "y": 3 }
  ],
  "playerStart": { "x": 8, "y": 2 },
  "tiles": [
    [18, 18, 18, 18, 18, 17, 17, 17, 17, 17, 18, 18, 18, 18, 18, 18],
    [18, 17, 17, 17, 17, 17, 17, 17, 17, 17, 17, 17, 17, 17, 17, 18],
    [18, 17, 17, 17, 17, 17, 17, 17, 17, 17, 17, 17, 17, 17, 17, 18],
    [18, 17, 17, 17, 17, 17, 17, 17, 17, 17, 17, 17, 17, 17, 17, 18],
    [18, 17, 17, 17, 4, 4, 4, 4, 4, 4, 4, 4, 17, 17, 17, 18],
    [18, 17, 17, 17, 4, 4, 4, 4, 4, 4, 4, 4, 17, 17, 17, 18],
    [18, 17, 17, 17, 4, 4, 4, 4, 4, 4, 4, 4, 17, 17, 17, 18],
    [18, 17, 17, 17, 4, 4, 4, 4, 4, 4, 4, 4, 17, 17, 17, 18],
    [18, 17, 17, 17, 17, 17, 17, 17, 17, 17, 17, 17, 17, 17, 17, 18],
    [18, 17, 17, 17, 17, 17, 17, 17, 17, 17, 17, 17, 17, 17, 17, 18],
    [18, 17, 17, 17, 17, 17, 17, 17, 17, 17, 17, 17, 17, 17, 17, 18],
    [18, 18, 18, 18, 18, 17, 17, 17, 17, 17, 18, 18, 18, 18, 18, 18]
  ]
}
