{
  "id": "retail/food_court",
  "name": "Retail Ruins — Food Court",
  "fixedEnemies": true,
  "exits": {
    "up": "retail/entrance",
    "right": "retail/back_room"
  },
  "enemies": [
    { "type": "corrupted_cashier", "x": 5, "y": 4 },
    { "type": "price_scanner", "x": 10, "y": 7 }
  ],
  "playerStart": { "x": 8, "y": 2 },
  "tiles": [
    [18, 18, 18, 18, 18, 17, 17, 17, 17, 17, 18, 18, 18, 18, 18, 18],
    [18, 17, 17, 17, 17, 17, 17, 17, 17, 17, 17, 17, 17, 17, 17, 18],
    [18, 17, 19, 19, 17, 17, 17, 17, 17, 17, 19, 19, 17, 17, 17, 18],
    [18, 17, 19, 19, 17, 17, 17, 17, 17, 17, 19, 19, 17, 17, 17, 18],
    [18, 17, 17, 17, 17, 17, 17, 17, 17, 17, 17, 17, 17, 17, 17, 18],
    [18, 17, 17, 17, 17, 17, 17, 17, 17, 17, 17, 17, 17, 17, 17, 17],
    [18, 17, 17, 17, 17, 17, 17, 17, 17, 17, 17, 17, 17, 17, 17, 17],
    [18, 17, 17, 17, 17, 17, 17, 17, 17, 17, 17, 17, 17, 17, 17, 18],
    [18, 17, 19, 19, 17, 17, 17, 17, 17, 17, 19, 19, 17, 17, 17, 18],
    [18, 17, 19, 19, 17, 17, 17, 17, 17, 17, 19, 19, 17, 17, 17, 18],
    [18, 17, 17, 17, 17, 17, 17, 17, 17, 17, 17, 17, 17, 17, 17, 18],
    [18, 18, 18, 18, 18, 18, 18, 18, 18, 18, 18, 18, 18, 18, 18, 18]
  ]
}
