{
  "id": "sprawl/alley",
  "name": "The Sprawl — Dark Alley",
  "fixedEnemies": true,
  "exits": {
    "up": "sprawl/park",
    "down": "sprawl/dead_end"
  },
  "enemies": [
    { "type": "goblin_archer", "x": 6, "y": 4 },
    { "type": "goblin_archer", "x": 10, "y": 7 }
  ],
  "playerStart": { "x": 8, "y": 2 },
  "tiles": [
    [15, 15, 15, 15, 15, 14, 14, 14, 14, 14, 15, 15, 15, 15, 15, 15],
    [15, 15, 15, 16, 16, 14, 14, 14, 14, 14, 16, 16, 15, 15, 15, 15],
    [15, 15, 15, 16, 16, 14, 14, 14, 14, 14, 16, 16, 15, 15, 15, 15],
    [15, 15, 16, 16, 16, 14, 14, 14, 14, 14, 16, 16, 16, 15, 15, 15],
    [15, 15, 16, 16, 16, 14, 14, 14, 14, 14, 16, 16, 16, 15, 15, 15],
    [15, 16, 16, 16, 14, 14, 14, 14, 14, 14, 14, 16, 16, 16, 15, 15],
    [15, 16, 16, 16, 14, 14, 14, 14, 14, 14, 14, 16, 16, 16, 15, 15],
    [15, 15, 16, 16, 16, 14, 14, 14, 14, 14, 16, 16, 16, 15, 15, 15],
    [15, 15, 16, 16, 16, 14, 14, 14, 14, 14, 16, 16, 16, 15, 15, 15],
    [15, 15, 15, 16, 16, 14, 14, 14, 14, 14, 16, 16, 15, 15, 15, 15],
    [15, 15, 15, 16, 16, 14, 14, 14, 14, 14, 16, 16, 15, 15, 15, 15],
    [15, 15, 15, 15, 15, 14, 14, 14, 14, 14, 15, 15, 15, 15, 15, 15]
  ]
}
