{
  "id": "sprawl/bridge",
  "name": "The Sprawl — Bridge",
  "fixedEnemies": true,
  "exits": {
    "left": "sprawl/crossroads",
    "right": "retail/entrance"
  },
  "enemies": [
    { "type": "goblin_archer", "x": 6, "y": 5 },
    { "type": "feral_dog", "x": 11, "y": 6 }
  ],
  "playerStart": { "x": 2, "y": 6 },
  "tiles": [
    [15, 15, 15, 15, 15, 15, 15, 15, 15, 15, 15, 15, 15, 15, 15, 15],
    [15, 3, 3, 3, 3, 3, 3, 3, 3, 3, 3, 3, 3, 3, 3, 15],
    [15, 3, 3, 3, 3, 3, 3, 3, 3, 3, 3, 3, 3, 3, 3, 15],
    [15, 3, 3, 3, 3, 3, 3, 3, 3, 3, 3, 3, 3, 3, 3, 15],
    [15, 15, 15, 14, 14, 14, 14, 14, 14, 14, 14, 14, 14, 15, 15, 15],
    [14, 14, 14, 14, 14, 14, 14, 14, 14, 14, 14, 14, 14, 14, 14, 14],
    [14, 14, 14, 14, 14, 14, 14, 14, 14, 14, 14, 14, 14, 14, 14, 14],
    [15, 15, 15, 14, 14, 14, 14, 14, 14, 14, 14, 14, 14, 15, 15, 15],
    [15, 3, 3, 3, 3, 3, 3, 3, 3, 3, 3, 3, 3, 3, 3, 15],
    [15, 3, 3, 3, 3, 3, 3, 3, 3, 3, 3, 3, 3, 3, 3, 15],
    [15, 3, 3, 3, 3, 3, 3, 3, 3, 3, 3, 3, 3, 3, 3, 15],
    [15, 15, 15, 15, 15, 15, 15, 15, 15, 15, 15, 15, 15, 15, 15, 15]
  ]
}
