{
  "id": "sprawl/camp",
  "name": "The Sprawl — Campsite",
  "safe": true,
  "exits": {
    "up": "sprawl/crossroads",
    "down": "gym/locker_room"
  },
  "campfires": [
    { "x": 8, "y": 5 }
  ],
  "playerStart": { "x": 8, "y": 2 },
  "tiles": [
    [15, 15, 15, 15, 15, 14, 14, 14, 14, 14, 15, 15, 15, 15, 15, 15],
    [15, 16, 16, 16, 16, 14, 14, 14, 14, 14, 16, 16, 16, 16, 16, 15],
    [15, 16, 16, 16, 16, 14, 14, 14, 14, 14, 16, 16, 16, 16, 16, 15],
    [15, 16, 16, 16, 16, 16, 16, 16, 16, 16, 16, 16, 16, 16, 16, 15],
    [15, 16, 16, 16, 16, 16, 16, 16, 16, 16, 16, 16, 16, 16, 16, 15],
    [15, 16, 16, 16, 16, 16, 16, 16, 16, 16, 16, 16, 16, 16, 16, 15],
    [15, 16, 16, 16, 16, 16, 16, 16, 16, 16, 16, 16, 16, 16, 16, 15],
    [15, 16, 16, 16, 16, 16, 16, 16, 16, 16, 16, 16, 16, 16, 16, 15],
    [15, 16, 16, 16, 16, 16, 16, 16, 16, 16, 16, 16, 16, 16, 16, 15],
    [15, 16, 16, 16, 16, 16, 16, 16, 16, 16, 16, 16, 16, 16, 16, 15],
    [15, 16, 16, 16, 16, 16, 16, 16, 16, 16, 16, 16, 16, 16, 16, 15],
    [15, 15, 15, 15, 15, 14, 14, 14, 14, 14, 15, 15, 15, 15, 15, 15]
  ]
}
