{
  "id": "sprawl/dead_end",
  "name": "The Sprawl — Dead End",
  "fixedEnemies": true,
  "exits": {
    "up": "sprawl/alley",
    "left": "sprawl/houses"
  },
  "enemies": [
    { "type": "goblin_archer", "x": 6, "y": 5 },
    { "type": "goblin_archer", "x": 10, "y": 7 }
  ],
  "chests": [
    { "x": 13, "y": 3, "loot": [{ "itemId": "baseball_bat", "qty": 1 }], "gold": 25 }
  ],
  "playerStart": { "x": 8, "y": 6 },
  "tiles": [
    [15, 15, 15, 15, 15, 14, 14, 14, 14, 14, 15, 15, 15, 15, 15, 15],
    [15, 16, 16, 16, 16, 14, 14, 14, 14, 14, 16, 16, 16, 16, 16, 15],
    [15, 16, 16, 16, 16, 14, 14, 14, 14, 14, 16, 16, 16, 16, 16, 15],
    [15, 16, 16, 16, 16, 14, 14, 14, 14, 14, 16, 16, 16, 9, 16, 15],
    [14, 14, 14, 14, 14, 14, 14, 14, 14, 14, 14, 14, 14, 14, 14, 15],
    [14, 14, 14, 14, 14, 14, 14, 14, 14, 14, 14, 14, 14, 14, 14, 15],
    [14, 14, 14, 14, 14, 14, 14, 14, 14, 14, 14, 14, 14, 14, 14, 15],
    [15, 16, 16, 16, 16, 16, 16, 16, 16, 16, 16, 16, 16, 16, 16, 15],
    [15, 16, 16, 16, 16, 16, 16, 16, 16, 16, 16, 16, 16, 16, 16, 15],
    [15, 16, 16, 16, 16, 16, 16, 16, 16, 16, 16, 16, 16, 16, 16, 15],
    [15, 16, 16, 16, 16, 16, 16, 16, 16, 16, 16, 16, 16, 16, 16, 15],
    [15, 15, 15, 15, 15, 15, 15, 15, 15, 15, 15, 15, 15, 15, 15, 15]
  ]
}
