{
  "id": "sprawl/entrance",
  "name": "The Sprawl — Entrance",
  "safe": true,
  "fixedEnemies": true,
  "exits": {
    "up": "grymhold/town_1",
    "right": "sprawl/street_1"
  },
  "enemies": [
    { "type": "feral_dog", "x": 6, "y": 4 },
    { "type": "feral_dog", "x": 11, "y": 7 }
  ],
  "playerStart": { "x": 8, "y": 2 },
  "tiles": [
    [15, 15, 15, 15, 15, 14, 14, 14, 14, 14, 15, 15, 15, 15, 15, 15],
    [15, 16, 16, 16, 16, 14, 14, 14, 14, 14, 16, 16, 16, 16, 16, 15],
    [15, 16, 16, 16, 16, 14, 14, 14, 14, 14, 16, 16, 16, 16, 16, 15],
    [15, 16, 16, 16, 16, 14, 14, 14, 14, 14, 16, 16, 16, 16, 16, 15],
    [15, 16, 16, 16, 16, 14, 14, 14, 14, 14, 16, 16, 16, 16, 16, 15],
    [14, 14, 14, 14, 14, 14, 14, 14, 14, 14, 14, 14, 14, 14, 14, 14],
    [14, 14, 14, 14, 14, 14, 14, 14, 14, 14, 14, 14, 14, 14, 14, 14],
    [15, 16, 16, 16, 16, 14, 14, 14, 14, 14, 16, 16, 16, 16, 16, 15],
    [15, 16, 16, 16, 16, 14, 14, 14, 14, 14, 16, 16, 16, 16, 16, 15],
    [15, 16, 16, 16, 16, 14, 14, 14, 14, 14, 16, 16, 16, 16, 16, 15],
    [15, 16, 16, 16, 16, 14, 14, 14, 14, 14, 16, 16, 16, 16, 16, 15],
    [15, 15, 15, 15, 15, 15, 15, 15, 15, 15, 15, 15, 15, 15, 15, 15]
  ]
}
