{
  "id": "sprawl/park",
  "name": "The Sprawl — Overgrown Park",
  "fixedEnemies": true,
  "exits": {
    "left": "sprawl/street_1",
    "down": "sprawl/alley"
  },
  "enemies": [
    { "type": "feral_rat", "x": 3, "y": 3 },
    { "type": "feral_rat", "x": 12, "y": 8 }
  ],
  "npcs": [
    { "npcId": "destiny", "x": 8, "y": 4 }
  ],
  "playerStart": { "x": 8, "y": 6 },
  "tiles": [
    [15, 15, 15, 15, 15, 15, 15, 15, 15, 15, 15, 15, 15, 15, 15, 15],
    [15, 16, 16, 16, 16, 16, 16, 16, 16, 16, 16, 16, 16, 16, 16, 15],
    [15, 16, 16, 16, 16, 16, 1, 1, 1, 1, 16, 16, 16, 16, 16, 15],
    [15, 16, 16, 16, 16, 1, 1, 1, 1, 1, 1, 16, 16, 16, 16, 15],
    [15, 16, 16, 16, 1, 1, 1, 1, 1, 1, 1, 1, 16, 16, 16, 15],
    [14, 14, 14, 14, 1, 1, 1, 1, 1, 1, 1, 1, 14, 14, 14, 15],
    [14, 14, 14, 14, 1, 1, 1, 1, 1, 1, 1, 1, 14, 14, 14, 15],
    [15, 16, 16, 16, 1, 1, 1, 1, 1, 1, 1, 1, 16, 16, 16, 15],
    [15, 16, 16, 16, 16, 1, 1, 1, 1, 1, 1, 16, 16, 16, 16, 15],
    [15, 16, 16, 16, 16, 16, 1, 1, 1, 1, 16, 16, 16, 16, 16, 15],
    [15, 16, 16, 16, 16, 16, 14, 14, 14, 14, 16, 16, 16, 16, 16, 15],
    [15, 15, 15, 15, 15, 15, 14, 14, 14, 14, 15, 15, 15, 15, 15, 15]
  ]
}
