{
  "id": "sprawl/street_2",
  "name": "The Sprawl — Side Street",
  "fixedEnemies": true,
  "exits": {
    "up": "sprawl/street_1",
    "down": "sprawl/houses"
  },
  "enemies": [
    { "type": "goblin_archer", "x": 5, "y": 4 },
    { "type": "feral_dog", "x": 11, "y": 7 },
    { "type": "feral_rat", "x": 3, "y": 8 }
  ],
  "playerStart": { "x": 8, "y": 2 },
  "tiles": [
    [15, 15, 15, 15, 15, 14, 14, 14, 14, 14, 15, 15, 15, 15, 15, 15],
    [15, 16, 16, 16, 16, 14, 14, 14, 14, 14, 16, 16, 16, 16, 16, 15],
    [15, 16, 16, 16, 16, 14, 14, 14, 14, 14, 16, 16, 16, 16, 16, 15],
    [15, 16, 16, 16, 16, 14, 14, 14, 14, 14, 16, 16, 16, 16, 16, 15],
    [15, 16, 16, 16, 16, 14, 14, 14, 14, 14, 16, 16, 16, 16, 16, 15],
    [14, 14, 14, 14, 14, 14, 14, 14, 14, 14, 14, 14, 14, 14, 14, 15],
    [14, 14, 14, 14, 14, 14, 14, 14, 14, 14, 14, 14, 14, 14, 14, 15],
    [15, 16, 16, 16, 16, 14, 14, 14, 14, 14, 16, 16, 16, 16, 16, 15],
    [15, 16, 16, 16, 16, 14, 14, 14, 14, 14, 16, 16, 16, 16, 16, 15],
    [15, 16, 16, 16, 16, 14, 14, 14, 14, 14, 16, 16, 16, 16, 16, 15],
    [15, 16, 16, 16, 16, 14, 14, 14, 14, 14, 16, 16, 16, 16, 16, 15],
    [15, 15, 15, 15, 15, 14, 14, 14, 14, 14, 15, 15, 15, 15, 15, 15]
  ]
}
