{
  "id": "sprawl/street_1",
  "name": "The Sprawl — Main Street",
  "fixedEnemies": true,
  "exits": {
    "left": "sprawl/entrance",
    "right": "sprawl/park",
    "down": "sprawl/street_2"
  },
  "enemies": [
    { "type": "feral_rat", "x": 4, "y": 3 },
    { "type": "feral_dog", "x": 10, "y": 8 },
    { "type": "goblin_archer", "x": 13, "y": 4 }
  ],
  "chests": [
    { "x": 2, "y": 2, "loot": [{ "itemId": "gas_station_burrito", "qty": 2 }], "gold": 15 }
  ],
  "playerStart": { "x": 8, "y": 6 },
  "tiles": [
    [15, 15, 15, 15, 15, 15, 15, 15, 15, 15, 15, 15, 15, 15, 15, 15],
    [15, 16, 16, 16, 16, 16, 16, 16, 16, 16, 16, 16, 16, 16, 16, 15],
    [15, 16, 9, 16, 16, 16, 16, 16, 16, 16, 16, 16, 16, 16, 16, 15],
    [15, 16, 16, 16, 16, 16, 16, 16, 16, 16, 16, 16, 16, 16, 16, 15],
    [15, 16, 16, 16, 16, 16, 16, 16, 16, 16, 16, 16, 16, 16, 16, 15],
    [14, 14, 14, 14, 14, 14, 14, 14, 14, 14, 14, 14, 14, 14, 14, 14],
    [14, 14, 14, 14, 14, 14, 14, 14, 14, 14, 14, 14, 14, 14, 14, 14],
    [15, 16, 16, 16, 16, 16, 16, 16, 16, 16, 16, 16, 16, 16, 16, 15],
    [15, 16, 16, 16, 16, 16, 16, 16, 16, 16, 16, 16, 16, 16, 16, 15],
    [15, 16, 16, 16, 16, 16, 16, 16, 16, 16, 16, 16, 16, 16, 16, 15],
    [15, 16, 16, 16, 16, 14, 14, 14, 14, 14, 16, 16, 16, 16, 16, 15],
    [15, 15, 15, 15, 15, 14, 14, 14, 14, 14, 15, 15, 15, 15, 15, 15]
  ]
}
