{
  "id": "labs/containment",
  "name": "The Labs — Containment",
  "fixedEnemies": true,
  "exits": {
    "left": "labs/antechamber"
  },
  "enemies": [
    { "type": "the_specimen", "x": 8, "y": 4 }
  ],
  "playerStart": { "x": 8, "y": 9 },
  "tiles": [
    [24, 24, 24, 24, 24, 24, 24, 24, 24, 24, 24, 24, 24, 24, 24, 24],
    [24, 23, 23, 23, 23, 23, 23, 23, 23, 23, 23, 23, 23, 23, 23, 24],
    [24, 23, 23, 23, 23, 23, 23, 23, 23, 23, 23, 23, 23, 23, 23, 24],
    [24, 23, 23, 25, 25, 23, 23, 23, 23, 23, 23, 25, 25, 23, 23, 24],
    [24, 23, 23, 25, 25, 23, 23, 23, 23, 23, 23, 25, 25, 23, 23, 24],
    [24, 23, 23, 23, 23, 23, 23, 23, 23, 23, 23, 23, 23, 23, 23, 24],
    [24, 23, 23, 23, 23, 23, 23, 23, 23, 23, 23, 23, 23, 23, 23, 24],
    [24, 23, 23, 25, 25, 23, 23, 23, 23, 23, 23, 25, 25, 23, 23, 24],
    [24, 23, 23, 25, 25, 23, 23, 23, 23, 23, 23, 25, 25, 23, 23, 24],
    [23, 23, 23, 23, 23, 23, 23, 23, 23, 23, 23, 23, 23, 23, 23, 24],
    [23, 23, 23, 23, 23, 23, 23, 23, 23, 23, 23, 23, 23, 23, 23, 24],
    [24, 24, 24, 24, 24, 24, 24, 24, 24, 24, 24, 24, 24, 24, 24, 24]
  ]
}
