{
  "id": "labs/corridor",
  "name": "The Labs — Corridor",
  "fixedEnemies": true,
  "exits": {
    "left": "labs/entrance",
    "right": "labs/holding_cells",
    "down": "labs/surgery"
  },
  "enemies": [
    { "type": "lab_chimera", "x": 7, "y": 3 },
    { "type": "experiment_pod", "x": 12, "y": 7 }
  ],
  "campfires": [
    { "x": 3, "y": 3 }
  ],
  "playerStart": { "x": 2, "y": 5 },
  "tiles": [
    [24, 24, 24, 24, 24, 24, 24, 24, 24, 24, 24, 24, 24, 24, 24, 24],
    [24, 23, 23, 23, 23, 23, 23, 23, 23, 23, 23, 23, 23, 23, 23, 24],
    [24, 23, 23, 23, 23, 23, 23, 23, 23, 23, 23, 23, 23, 23, 23, 24],
    [24, 23, 23, 23, 23, 23, 23, 23, 23, 23, 25, 23, 23, 23, 23, 24],
    [24, 23, 23, 23, 23, 23, 23, 23, 23, 23, 25, 23, 23, 23, 23, 24],
    [23, 23, 23, 23, 23, 23, 23, 23, 23, 23, 23, 23, 23, 23, 23, 23],
    [23, 23, 23, 23, 23, 23, 23, 23, 23, 23, 23, 23, 23, 23, 23, 23],
    [24, 23, 23, 23, 23, 25, 23, 23, 23, 23, 23, 23, 23, 23, 23, 24],
    [24, 23, 23, 23, 23, 25, 23, 23, 23, 23, 23, 23, 23, 23, 23, 24],
    [24, 23, 23, 23, 23, 23, 23, 23, 23, 23, 23, 23, 23, 23, 23, 24],
    [24, 24, 24, 24, 24, 23, 23, 23, 23, 23, 23, 24, 24, 24, 24, 24],
    [24, 24, 24, 24, 24, 23, 23, 23, 23, 23, 23, 24, 24, 24, 24, 24]
  ]
}
