{
  "id": "labs/entrance",
  "name": "The Labs — Entrance",
  "fixedEnemies": true,
  "exits": {
    "left": "gym/locker_room",
    "right": "labs/corridor"
  },
  "enemies": [
    { "type": "bio_mutant", "x": 6, "y": 4 },
    { "type": "rogue_ai", "x": 11, "y": 7 }
  ],
  "playerStart": { "x": 2, "y": 6 },
  "tiles": [
    [24, 24, 24, 24, 24, 24, 24, 24, 24, 24, 24, 24, 24, 24, 24, 24],
    [24, 23, 23, 23, 23, 23, 23, 23, 23, 23, 23, 23, 23, 23, 23, 24],
    [24, 23, 23, 23, 23, 23, 23, 23, 23, 23, 23, 23, 23, 23, 23, 24],
    [24, 23, 23, 25, 25, 23, 23, 23, 23, 23, 23, 23, 23, 23, 23, 24],
    [24, 23, 23, 25, 25, 23, 23, 23, 23, 23, 25, 25, 23, 23, 23, 24],
    [23, 23, 23, 23, 23, 23, 23, 23, 23, 23, 25, 25, 23, 23, 23, 23],
    [23, 23, 23, 23, 23, 23, 23, 23, 23, 23, 23, 23, 23, 23, 23, 23],
    [24, 23, 23, 23, 23, 23, 23, 23, 23, 23, 23, 23, 23, 23, 23, 24],
    [24, 23, 23, 23, 23, 23, 23, 23, 23, 25, 25, 23, 23, 23, 23, 24],
    [24, 23, 23, 23, 23, 23, 23, 23, 23, 25, 25, 23, 23, 23, 23, 24],
    [24, 23, 23, 23, 23, 23, 23, 23, 23, 23, 23, 23, 23, 23, 23, 24],
    [24, 24, 24, 24, 24, 24, 24, 24, 24, 24, 24, 24, 24, 24, 24, 24]
  ]
}
