{
  "id": "labs/genetic_vault",
  "name": "The Labs — Genetic Vault",
  "fixedEnemies": true,
  "exits": {
    "left": "labs/surgery",
    "down": "labs/secret_lab"
  },
  "enemies": [
    { "type": "lab_chimera", "x": 6, "y": 5 },
    { "type": "experiment_pod", "x": 12, "y": 3 }
  ],
  "chests": [
    { "x": 2, "y": 2, "loot": [{ "itemId": "scanner", "qty": 2 }], "gold": 60 }
  ],
  "playerStart": { "x": 2, "y": 6 },
  "tiles": [
    [24, 24, 24, 24, 24, 24, 24, 24, 24, 24, 24, 24, 24, 24, 24, 24],
    [24, 23, 23, 23, 23, 23, 23, 23, 23, 23, 23, 23, 23, 23, 23, 24],
    [24, 23, 9, 23, 23, 23, 23, 23, 23, 25, 25, 23, 23, 23, 23, 24],
    [24, 23, 23, 23, 23, 23, 23, 23, 23, 25, 25, 23, 23, 23, 23, 24],
    [24, 23, 23, 25, 25, 23, 23, 23, 23, 23, 23, 23, 23, 23, 23, 24],
    [23, 23, 23, 25, 25, 23, 23, 23, 23, 23, 23, 25, 25, 23, 23, 24],
    [23, 23, 23, 23, 23, 23, 23, 23, 23, 23, 23, 25, 25, 23, 23, 24],
    [24, 23, 23, 23, 23, 23, 23, 23, 23, 23, 23, 23, 23, 23, 23, 24],
    [24, 23, 23, 23, 23, 23, 23, 23, 23, 23, 23, 23, 23, 23, 23, 24],
    [24, 23, 23, 23, 23, 23, 23, 23, 23, 23, 23, 23, 23, 23, 23, 24],
    [24, 24, 24, 24, 24, 23, 23, 23, 23, 23, 23, 24, 24, 24, 24, 24],
    [24, 24, 24, 24, 24, 23, 23, 23, 23, 23, 23, 24, 24, 24, 24, 24]
  ]
}
