{
  "id": "labs/holding_cells",
  "name": "The Labs — Holding Cells",
  "fixedEnemies": true,
  "exits": {
    "left": "labs/corridor",
    "down": "labs/server_room"
  },
  "enemies": [
    { "type": "bio_mutant", "x": 10, "y": 3 },
    { "type": "rogue_ai", "x": 12, "y": 8 }
  ],
  "npcs": [
    { "npcId": "tiffany", "x": 6, "y": 4 }
  ],
  "playerStart": { "x": 2, "y": 5 },
  "tiles": [
    [24, 24, 24, 24, 24, 24, 24, 24, 24, 24, 24, 24, 24, 24, 24, 24],
    [24, 23, 23, 23, 23, 23, 23, 23, 24, 23, 23, 23, 23, 23, 23, 24],
    [24, 23, 25, 25, 23, 23, 23, 23, 24, 23, 25, 25, 23, 23, 23, 24],
    [24, 23, 25, 25, 23, 23, 23, 23, 24, 23, 25, 25, 23, 23, 23, 24],
    [24, 23, 23, 23, 23, 23, 23, 23, 23, 23, 23, 23, 23, 23, 23, 24],
    [23, 23, 23, 23, 23, 23, 23, 23, 23, 23, 23, 23, 23, 23, 23, 24],
    [23, 23, 23, 23, 23, 23, 23, 23, 23, 23, 23, 23, 23, 23, 23, 24],
    [24, 23, 25, 25, 23, 23, 23, 23, 24, 23, 25, 25, 23, 23, 23, 24],
    [24, 23, 25, 25, 23, 23, 23, 23, 24, 23, 25, 25, 23, 23, 23, 24],
    [24, 23, 23, 23, 23, 23, 23, 23, 24, 23, 23, 23, 23, 23, 23, 24],
    [24, 24, 24, 24, 24, 23, 23, 23, 23, 23, 23, 24, 24, 24, 24, 24],
    [24, 24, 24, 24, 24, 23, 23, 23, 23, 23, 23, 24, 24, 24, 24, 24]
  ]
}
