{
  "id": "labs/server_room",
  "name": "The Labs — Server Room",
  "fixedEnemies": true,
  "exits": {
    "up": "labs/holding_cells",
    "down": "labs/sub_basement"
  },
  "enemies": [
    { "type": "rogue_ai", "x": 5, "y": 4 },
    { "type": "rogue_ai", "x": 11, "y": 7 }
  ],
  "playerStart": { "x": 8, "y": 2 },
  "tiles": [
    [24, 24, 24, 24, 24, 23, 23, 23, 23, 23, 23, 24, 24, 24, 24, 24],
    [24, 23, 23, 23, 23, 23, 23, 23, 23, 23, 23, 23, 23, 23, 23, 24],
    [24, 23, 25, 23, 23, 23, 23, 23, 23, 23, 23, 25, 23, 23, 23, 24],
    [24, 23, 25, 23, 23, 23, 23, 23, 23, 23, 23, 25, 23, 23, 23, 24],
    [24, 23, 23, 23, 23, 23, 23, 23, 23, 23, 23, 23, 23, 23, 23, 24],
    [24, 23, 25, 23, 23, 23, 23, 23, 23, 23, 23, 25, 23, 23, 23, 24],
    [24, 23, 25, 23, 23, 23, 23, 23, 23, 23, 23, 25, 23, 23, 23, 24],
    [24, 23, 23, 23, 23, 23, 23, 23, 23, 23, 23, 23, 23, 23, 23, 24],
    [24, 23, 25, 23, 23, 23, 23, 23, 23, 23, 23, 25, 23, 23, 23, 24],
    [24, 23, 25, 23, 23, 23, 23, 23, 23, 23, 23, 25, 23, 23, 23, 24],
    [24, 24, 24, 24, 24, 23, 23, 23, 23, 23, 23, 24, 24, 24, 24, 24],
    [24, 24, 24, 24, 24, 23, 23, 23, 23, 23, 23, 24, 24, 24, 24, 24]
  ]
}
