{
  "id": "labs/surgery",
  "name": "The Labs — Surgery",
  "fixedEnemies": true,
  "exits": {
    "up": "labs/corridor",
    "right": "labs/genetic_vault"
  },
  "enemies": [
    { "type": "lab_chimera", "x": 4, "y": 4 },
    { "type": "bio_mutant", "x": 10, "y": 3 },
    { "type": "experiment_pod", "x": 11, "y": 8 }
  ],
  "chests": [
    { "x": 13, "y": 2, "loot": [{ "itemId": "name_brand_energy_drink", "qty": 2 }], "gold": 40 }
  ],
  "playerStart": { "x": 8, "y": 2 },
  "tiles": [
    [24, 24, 24, 24, 24, 23, 23, 23, 23, 23, 23, 24, 24, 24, 24, 24],
    [24, 23, 23, 23, 23, 23, 23, 23, 23, 23, 23, 23, 23, 23, 23, 24],
    [24, 23, 23, 23, 23, 23, 23, 23, 23, 23, 23, 23, 23, 9, 23, 24],
    [24, 23, 23, 25, 23, 23, 23, 23, 23, 23, 23, 23, 23, 23, 23, 24],
    [24, 23, 23, 25, 23, 23, 23, 23, 23, 23, 25, 23, 23, 23, 23, 24],
    [24, 23, 23, 23, 23, 23, 23, 23, 23, 23, 25, 23, 23, 23, 23, 23],
    [24, 23, 23, 23, 23, 23, 23, 23, 23, 23, 23, 23, 23, 23, 23, 23],
    [24, 23, 23, 23, 23, 25, 25, 23, 23, 23, 23, 23, 23, 23, 23, 24],
    [24, 23, 23, 23, 23, 25, 25, 23, 23, 23, 23, 23, 23, 23, 23, 24],
    [24, 23, 23, 23, 23, 23, 23, 23, 23, 23, 23, 23, 23, 23, 23, 24],
    [24, 23, 23, 23, 23, 23, 23, 23, 23, 23, 23, 23, 23, 23, 23, 24],
    [24, 24, 24, 24, 24, 24, 24, 24, 24, 24, 24, 24, 24, 24, 24, 24]
  ]
}
