{
  "id": "grymhold/town_6",
  "name": "Grymhold — Blacksmith",
  "safe": true,
  "exits": {
    "left": "grymhold/town_5",
    "right": "grymhold/town_7"
  },
  "npcs": [
    { "npcId": "gus", "x": 8, "y": 4 }
  ],
  "playerStart": { "x": 8, "y": 6 },
  "tiles": [
    [2, 2, 2, 2, 2, 2, 2, 2, 2, 2, 2, 2, 2, 2, 2, 2],
    [4, 4, 1, 10, 10, 10, 10, 10, 10, 10, 10, 10, 10, 1, 4, 4],
    [4, 4, 1, 10, 6, 6, 6, 6, 6, 6, 6, 6, 10, 1, 4, 4],
    [4, 4, 1, 10, 6, 6, 6, 6, 6, 6, 6, 6, 10, 1, 4, 4],
    [4, 4, 1, 10, 6, 6, 6, 6, 6, 6, 6, 6, 10, 1, 4, 4],
    [4, 4, 4, 4, 4, 4, 4, 4, 4, 4, 4, 4, 4, 4, 4, 4],
    [4, 4, 4, 4, 4, 4, 4, 4, 4, 4, 4, 4, 4, 4, 4, 4],
    [4, 4, 1, 1, 1, 1, 1, 1, 1, 1, 1, 1, 1, 1, 4, 4],
    [4, 4, 1, 1, 1, 1, 1, 1, 1, 1, 1, 1, 1, 1, 4, 4],
    [4, 4, 1, 1, 1, 1, 1, 1, 1, 1, 1, 1, 1, 1, 4, 4],
    [4, 4, 1, 1, 1, 1, 1, 1, 1, 1, 1, 1, 1, 1, 4, 4],
    [2, 2, 2, 2, 2, 2, 2, 2, 2, 2, 2, 2, 2, 2, 2, 2]
  ]
}
