{
  "id": "grymhold/town_7",
  "name": "Grymhold — Residential",
  "safe": true,
  "exits": {
    "left": "grymhold/town_6",
    "right": "grymhold/town_8"
  },
  "npcs": [
    { "npcId": "brianna", "x": 8, "y": 4 }
  ],
  "shops": [
    { "type": "gear_shop", "x": 10, "y": 4 }
  ],
  "playerStart": { "x": 8, "y": 6 },
  "tiles": [
    [2, 2, 2, 2, 2, 2, 2, 2, 2, 2, 2, 2, 2, 2, 2, 2],
    [4, 4, 1, 1, 10, 10, 1, 1, 1, 1, 10, 10, 1, 1, 4, 4],
    [4, 4, 1, 1, 10, 10, 1, 1, 1, 1, 10, 10, 1, 1, 4, 4],
    [4, 4, 1, 1, 1, 1, 1, 1, 1, 1, 1, 1, 1, 1, 4, 4],
    [4, 4, 1, 1, 1, 1, 1, 1, 1, 1, 1, 1, 1, 1, 4, 4],
    [4, 4, 4, 4, 4, 4, 4, 4, 4, 4, 4, 4, 4, 4, 4, 4],
    [4, 4, 4, 4, 4, 4, 4, 4, 4, 4, 4, 4, 4, 4, 4, 4],
    [4, 4, 1, 1, 10, 10, 1, 1, 1, 1, 10, 10, 1, 1, 4, 4],
    [4, 4, 1, 1, 10, 10, 1, 1, 1, 1, 10, 10, 1, 1, 4, 4],
    [4, 4, 1, 1, 1, 1, 1, 1, 1, 1, 1, 1, 1, 1, 4, 4],
    [4, 4, 1, 1, 1, 1, 1, 1, 1, 1, 1, 1, 1, 1, 4, 4],
    [2, 2, 2, 2, 2, 2, 2, 2, 2, 2, 2, 2, 2, 2, 2, 2]
  ]
}
