{
  "id": "grymhold/town_3",
  "name": "Grymhold — Inn",
  "safe": true,
  "exits": {
    "left": "grymhold/town_2",
    "right": "grymhold/town_4"
  },
  "npcs": [
    { "npcId": "innkeeper", "x": 8, "y": 4 }
  ],
  "campfires": [
    { "x": 6, "y": 4 }
  ],
  "playerStart": { "x": 8, "y": 6 },
  "tiles": [
    [2, 2, 2, 2, 2, 2, 2, 2, 2, 2, 2, 2, 2, 2, 2, 2],
    [4, 4, 1, 1, 10, 10, 10, 10, 10, 10, 10, 10, 1, 1, 4, 4],
    [4, 4, 1, 1, 10, 6, 6, 6, 6, 6, 6, 10, 1, 1, 4, 4],
    [4, 4, 1, 1, 10, 6, 6, 6, 6, 6, 6, 10, 1, 1, 4, 4],
    [4, 4, 1, 1, 10, 6, 6, 6, 6, 6, 6, 10, 1, 1, 4, 4],
    [4, 4, 4, 4, 4, 4, 4, 4, 4, 4, 4, 4, 4, 4, 4, 4],
    [4, 4, 4, 4, 4, 4, 4, 4, 4, 4, 4, 4, 4, 4, 4, 4],
    [4, 4, 1, 1, 10, 10, 10, 10, 10, 10, 10, 10, 1, 1, 4, 4],
    [4, 4, 1, 1, 1, 1, 1, 1, 1, 1, 1, 1, 1, 1, 4, 4],
    [4, 4, 1, 1, 1, 1, 1, 1, 1, 1, 1, 1, 1, 1, 4, 4],
    [4, 4, 1, 1, 1, 1, 1, 1, 1, 1, 1, 1, 1, 1, 4, 4],
    [2, 2, 2, 2, 2, 2, 2, 2, 2, 2, 2, 2, 2, 2, 2, 2]
  ]
}
