{
  "id": "grymhold/town_1",
  "name": "Grymhold — Town Center",
  "exits": {
    "right": "grymhold/town_2"
  },
  "shops": [
    { "type": "potion_shop", "x": 3, "y": 5 }
  ],
  "playerStart": { "x": 8, "y": 6 },
  "tiles": [
    [2, 2, 2, 2, 2, 2, 2, 2, 2, 2, 2, 2, 2, 2, 2, 2],
    [2, 1, 1, 1, 1, 4, 4, 1, 1, 4, 4, 1, 1, 1, 1, 2],
    [2, 1, 1, 1, 1, 4, 4, 1, 1, 4, 4, 1, 1, 1, 1, 2],
    [2, 1, 1, 10, 10, 4, 4, 10, 10, 4, 4, 10, 10, 1, 1, 2],
    [2, 1, 1, 10, 10, 4, 4, 10, 10, 4, 4, 10, 10, 1, 1, 2],
    [2, 4, 4, 4, 4, 4, 4, 4, 4, 4, 4, 4, 4, 4, 4, 4],
    [2, 4, 4, 4, 4, 4, 4, 4, 4, 4, 4, 4, 4, 4, 4, 4],
    [2, 1, 1, 10, 10, 4, 4, 1, 1, 4, 4, 10, 10, 1, 1, 2],
    [2, 1, 1, 10, 10, 4, 4, 1, 1, 4, 4, 10, 10, 1, 1, 2],
    [2, 1, 1, 1, 1, 4, 4, 1, 1, 4, 4, 1, 1, 1, 1, 2],
    [2, 1, 1, 1, 1, 4, 4, 1, 1, 4, 4, 1, 1, 1, 1, 2],
    [2, 2, 2, 2, 2, 2, 2, 2, 2, 2, 2, 2, 2, 2, 2, 2]
  ]
}
