{
  "id": "grymhold/town_2",
  "name": "Grymhold — East Quarter",
  "exits": {
    "left": "grymhold/town_1",
    "right": "cave_1/room_1"
  },
  "shops": [
    { "type": "gear_shop", "x": 8, "y": 5 }
  ],
  "playerStart": { "x": 8, "y": 6 },
  "tiles": [
    [2, 2, 2, 2, 2, 2, 2, 2, 2, 2, 2, 2, 2, 2, 2, 2],
    [4, 4, 1, 1, 1, 1, 1, 1, 1, 1, 1, 1, 1, 1, 1, 2],
    [4, 4, 1, 1, 1, 1, 1, 1, 1, 1, 1, 1, 1, 1, 1, 2],
    [4, 4, 1, 1, 10, 10, 1, 1, 1, 1, 1, 3, 3, 3, 1, 2],
    [4, 4, 1, 1, 10, 10, 1, 1, 1, 1, 1, 3, 3, 3, 1, 2],
    [4, 4, 4, 4, 4, 4, 4, 4, 4, 4, 4, 4, 4, 4, 5, 5],
    [4, 4, 4, 4, 4, 4, 4, 4, 4, 4, 4, 4, 4, 4, 5, 5],
    [4, 4, 1, 1, 10, 10, 1, 1, 1, 1, 1, 3, 3, 3, 1, 2],
    [4, 4, 1, 1, 10, 10, 1, 1, 1, 1, 1, 3, 3, 3, 1, 2],
    [4, 4, 1, 1, 1, 1, 1, 1, 1, 1, 1, 1, 1, 1, 1, 2],
    [4, 4, 1, 1, 1, 1, 1, 1, 1, 1, 1, 1, 1, 1, 1, 2],
    [2, 2, 2, 2, 2, 2, 2, 2, 2, 2, 2, 2, 2, 2, 2, 2]
  ]
}
